# mouseleft, line x, column y => (x-2, y-1)
@@@@@@@@@@@@
@..........@
@..@@...@..@
@.......@..@
@...@......@
@@.........@
@...@...@..@
@@.........@
@....@..@@.@
@.@...P....@
@......@...@
@@@@@@@@@@@@
