@@@@@@
@....@
@.@..@
@..@.@
@....@
@@@@@@